//MAP CONVERTED BY dmm2tgm.py THIS HEADER COMMENT PREVENTS RECONVERSION, DO NOT REMOVE
"ac" = (
/obj/effect/floor_decal/corner/purple/diagonal,
/obj/structure/table/steel,
/obj/machinery/cell_charger,
/turf/simulated/floor/tiled/steel_grid,
/area/map_template/abandoned_church)
"aj" = (
/obj/structure/table/woodentable,
/obj/item/clothing/mask/gas/budget,
/turf/simulated/floor/tiled/dark,
/area/map_template/abandoned_church)
"ak" = (
/obj/effect/floor_decal/corner/blue/diagonal,
/obj/structure/cable/yellow{
	d1 = 1;
	d2 = 4;
	icon_state = "1-4"
	},
/turf/simulated/floor/tiled/freezer,
/area/map_template/abandoned_church)
"bZ" = (
/obj/effect/floor_decal/corner/green/diagonal,
/obj/machinery/light/small,
/turf/simulated/floor/tiled,
/area/map_template/abandoned_church)
"cc" = (
/obj/structure/cable/yellow{
	d1 = 1;
	d2 = 2;
	icon_state = "1-2"
	},
/turf/simulated/floor/tiled/dark,
/area/map_template/abandoned_church)
"dp" = (
/obj/random/trash,
/obj/machinery/light_switch{
	pixel_x = -24;
	pixel_y = -6
	},
/obj/machinery/button/windowtint{
	id = "abandoned_church";
	pixel_x = -24;
	pixel_y = 6
	},
/turf/simulated/floor/carpet/blue,
/area/map_template/abandoned_church)
"es" = (
/obj/machinery/door/airlock/civilian,
/obj/structure/cable/yellow{
	d1 = 1;
	d2 = 2;
	icon_state = "1-2"
	},
/turf/simulated/floor/tiled/dark,
/area/map_template/abandoned_church)
"eW" = (
/obj/machinery/mining/brace{
	dir = 8
	},
/obj/effect/floor_decal/corner/brown/diagonal,
/obj/machinery/light{
	dir = 1
	},
/turf/simulated/floor/tiled/dark,
/area/map_template/abandoned_church)
"fe" = (
/obj/machinery/light{
	dir = 4
	},
/turf/simulated/floor/carpet/blue,
/area/map_template/abandoned_church)
"fZ" = (
/obj/machinery/door/airlock/medical,
/obj/effect/floor_decal/corner/blue/diagonal,
/obj/structure/cable/yellow{
	d1 = 4;
	d2 = 8;
	icon_state = "4-8"
	},
/turf/simulated/floor/tiled/freezer,
/area/map_template/abandoned_church)
"gE" = (
/obj/structure/table/woodentable,
/obj/item/pickaxe,
/obj/machinery/light/small{
	dir = 1
	},
/turf/simulated/floor/tiled/dark,
/area/map_template/abandoned_church)
"ih" = (
/obj/effect/floor_decal/corner/green/diagonal,
/obj/random/loot,
/obj/structure/table/woodentable/maple,
/obj/machinery/light/small,
/turf/simulated/floor/tiled,
/area/map_template/abandoned_church)
"iP" = (
/obj/effect/floor_decal/corner/blue/diagonal,
/obj/machinery/computer/operating{
	dir = 1
	},
/turf/simulated/floor/tiled/freezer,
/area/map_template/abandoned_church)
"jy" = (
/obj/effect/floor_decal/corner/brown/diagonal,
/obj/structure/cable/yellow{
	d1 = 4;
	d2 = 8;
	icon_state = "4-8"
	},
/turf/simulated/floor/tiled/dark,
/area/map_template/abandoned_church)
"jR" = (
/obj/structure/bed/chair/wood{
	dir = 1
	},
/obj/effect/floor_decal/carpet/blue{
	dir = 1
	},
/obj/effect/floor_decal/carpet/blue{
	dir = 4
	},
/obj/effect/floor_decal/carpet/blue{
	dir = 5
	},
/turf/simulated/floor/wood/maple,
/area/map_template/abandoned_church)
"lw" = (
/obj/structure/bed/chair/wood{
	dir = 1
	},
/obj/effect/floor_decal/carpet/blue{
	dir = 8
	},
/obj/effect/floor_decal/carpet/blue{
	dir = 1
	},
/obj/effect/floor_decal/carpet/blue{
	dir = 9
	},
/turf/simulated/floor/wood/maple,
/area/map_template/abandoned_church)
"mj" = (
/obj/structure/ore_box,
/turf/simulated/floor/tiled/dark,
/area/map_template/abandoned_church)
"mY" = (
/obj/effect/floor_decal/corner/blue/diagonal,
/obj/structure/table/reinforced,
/obj/item/storage/firstaid/regular{
	pixel_x = 5;
	pixel_y = 7
	},
/obj/item/storage/firstaid/trauma{
	pixel_x = -5
	},
/obj/random/medical,
/obj/machinery/light{
	dir = 1
	},
/turf/simulated/floor/tiled/freezer,
/area/map_template/abandoned_church)
"nd" = (
/obj/effect/floor_decal/corner/purple/diagonal,
/turf/simulated/floor/tiled/steel_grid,
/area/map_template/abandoned_church)
"nA" = (
/obj/structure/bed/chair/wood{
	dir = 1
	},
/obj/effect/floor_decal/carpet/blue{
	dir = 4
	},
/obj/effect/floor_decal/carpet/blue,
/obj/effect/floor_decal/carpet/blue{
	dir = 6
	},
/turf/simulated/floor/wood/maple,
/area/map_template/abandoned_church)
"od" = (
/obj/effect/floor_decal/corner/purple/diagonal,
/obj/structure/table/steel,
/obj/machinery/recharger,
/turf/simulated/floor/tiled/steel_grid,
/area/map_template/abandoned_church)
"oi" = (
/obj/effect/floor_decal/corner/grey/border,
/turf/simulated/floor/tiled/dark,
/area/map_template/abandoned_church)
"ov" = (
/obj/effect/floor_decal/corner/purple/diagonal,
/obj/random/trash,
/turf/simulated/floor/tiled/steel_grid,
/area/map_template/abandoned_church)
"pK" = (
/obj/effect/floor_decal/corner/green/diagonal,
/obj/machinery/door/airlock/civilian,
/turf/simulated/floor/tiled,
/area/map_template/abandoned_church)
"pX" = (
/obj/structure/cable/yellow{
	d1 = 4;
	d2 = 8;
	icon_state = "4-8"
	},
/turf/simulated/floor/carpet/blue,
/area/map_template/abandoned_church)
"rg" = (
/obj/effect/floor_decal/corner/green/diagonal,
/obj/structure/bed,
/obj/item/bedsheet/purple,
/turf/simulated/floor/tiled,
/area/map_template/abandoned_church)
"rS" = (
/obj/machinery/r_n_d/circuit_imprinter,
/obj/effect/floor_decal/corner/purple/diagonal,
/turf/simulated/floor/tiled/steel_grid,
/area/map_template/abandoned_church)
"sp" = (
/obj/structure/bed/chair/wood{
	dir = 1
	},
/obj/effect/floor_decal/carpet/blue/corners{
	dir = 9
	},
/turf/simulated/floor/wood/maple,
/area/map_template/abandoned_church)
"tM" = (
/obj/structure/bed/chair/wood{
	dir = 1
	},
/obj/effect/floor_decal/carpet/blue/corners{
	dir = 5
	},
/turf/simulated/floor/wood/maple,
/area/map_template/abandoned_church)
"us" = (
/obj/machinery/r_n_d/protolathe,
/obj/effect/floor_decal/corner/purple/diagonal,
/turf/simulated/floor/tiled/steel_grid,
/area/map_template/abandoned_church)
"uD" = (
/obj/structure/bed/chair/wood{
	dir = 1
	},
/obj/effect/floor_decal/carpet/blue,
/turf/simulated/floor/wood/maple,
/area/map_template/abandoned_church)
"uJ" = (
/obj/structure/table/woodentable/maple,
/obj/item/storage/bible{
	deity_name = "Omnissiah";
	desc = "A holy book depicting ancient rituals of a cult that worshipped machines.";
	icon_state = "scientology";
	name = "Credo Omnissiah"
	},
/turf/simulated/floor/carpet/blue,
/area/map_template/abandoned_church)
"vm" = (
/obj/machinery/door/airlock/glass/civilian,
/obj/effect/floor_decal/corner/green/diagonal,
/turf/simulated/floor/tiled,
/area/map_template/abandoned_church)
"vx" = (
/obj/effect/wallframe_spawn/reinforced/polarized/no_grille{
	id = "techcult_window"
	},
/turf/simulated/floor/plating,
/area/map_template/abandoned_church)
"wa" = (
/obj/effect/floor_decal/corner/blue/diagonal,
/obj/machinery/optable,
/turf/simulated/floor/tiled/freezer,
/area/map_template/abandoned_church)
"wc" = (
/obj/machinery/door/airlock/mining,
/obj/effect/floor_decal/corner/brown/diagonal,
/obj/structure/cable/yellow{
	d1 = 4;
	d2 = 8;
	icon_state = "4-8"
	},
/turf/simulated/floor/tiled/dark,
/area/map_template/abandoned_church)
"wr" = (
/turf/simulated/floor/tiled/dark,
/area/map_template/abandoned_church)
"wv" = (
/obj/effect/floor_decal/corner/purple/diagonal,
/obj/machinery/light,
/turf/simulated/floor/tiled/steel_grid,
/area/map_template/abandoned_church)
"wF" = (
/obj/effect/floor_decal/corner/blue/diagonal,
/obj/structure/table/reinforced,
/obj/item/clothing/mask/surgical{
	pixel_y = 7
	},
/obj/item/clothing/suit/surgicalapron{
	pixel_x = 7
	},
/obj/item/storage/firstaid/surgery{
	pixel_y = -2
	},
/obj/machinery/light,
/turf/simulated/floor/tiled/freezer,
/area/map_template/abandoned_church)
"xC" = (
/obj/structure/bed/chair/wood{
	dir = 1
	},
/obj/effect/floor_decal/carpet/blue{
	dir = 4
	},
/turf/simulated/floor/wood/maple,
/area/map_template/abandoned_church)
"xT" = (
/turf/template_noop,
/area/template_noop)
"yT" = (
/obj/machinery/door/airlock/external,
/obj/structure/barricade,
/turf/simulated/floor/tiled/dark,
/area/map_template/abandoned_church)
"zz" = (
/obj/effect/floor_decal/corner/blue/diagonal,
/obj/random/trash,
/turf/simulated/floor/tiled/freezer,
/area/map_template/abandoned_church)
"zC" = (
/obj/effect/floor_decal/corner/blue/diagonal,
/turf/simulated/floor/tiled/freezer,
/area/map_template/abandoned_church)
"zP" = (
/obj/structure/bed/chair/wood{
	dir = 1
	},
/obj/effect/floor_decal/carpet/blue,
/obj/effect/floor_decal/carpet/blue{
	dir = 8
	},
/obj/effect/floor_decal/carpet/blue{
	dir = 10
	},
/turf/simulated/floor/wood/maple,
/area/map_template/abandoned_church)
"Al" = (
/obj/effect/floor_decal/corner/purple/diagonal,
/obj/structure/cable/yellow{
	d1 = 2;
	d2 = 4;
	icon_state = "2-4"
	},
/turf/simulated/floor/tiled/steel_grid,
/area/map_template/abandoned_church)
"Aq" = (
/obj/effect/floor_decal/corner/blue/diagonal,
/obj/structure/closet/secure_closet/medical1,
/obj/random/medical,
/turf/simulated/floor/tiled/freezer,
/area/map_template/abandoned_church)
"AE" = (
/obj/effect/floor_decal/corner/green/diagonal,
/obj/random/loot,
/obj/structure/table/woodentable/maple,
/obj/machinery/light/small{
	dir = 1
	},
/turf/simulated/floor/tiled,
/area/map_template/abandoned_church)
"AF" = (
/obj/effect/floor_decal/corner/purple/diagonal,
/obj/structure/closet/secure_closet/scientist,
/turf/simulated/floor/tiled/steel_grid,
/area/map_template/abandoned_church)
"Dc" = (
/obj/effect/floor_decal/corner/brown/diagonal,
/turf/simulated/floor/tiled/dark,
/area/map_template/abandoned_church)
"Dz" = (
/obj/structure/bed/chair/wood{
	dir = 1
	},
/obj/effect/floor_decal/carpet/blue{
	dir = 8
	},
/obj/effect/floor_decal/carpet/blue,
/obj/effect/floor_decal/carpet/blue{
	dir = 10
	},
/turf/simulated/floor/wood/maple,
/area/map_template/abandoned_church)
"DB" = (
/turf/simulated/wall/r_wall/prepainted,
/area/map_template/abandoned_church)
"DI" = (
/obj/effect/wallframe_spawn/reinforced,
/obj/structure/barricade,
/turf/simulated/floor/plating,
/area/map_template/abandoned_church)
"Ex" = (
/obj/structure/table/woodentable/maple,
/obj/random/loot,
/turf/simulated/floor/carpet/blue,
/area/map_template/abandoned_church)
"Fa" = (
/turf/simulated/floor/carpet/blue,
/area/map_template/abandoned_church)
"FA" = (
/obj/machinery/r_n_d/destructive_analyzer,
/obj/effect/floor_decal/corner/purple/diagonal,
/obj/machinery/light{
	dir = 1
	},
/turf/simulated/floor/tiled/steel_grid,
/area/map_template/abandoned_church)
"FO" = (
/obj/structure/table/woodentable,
/obj/item/device/scanner/mining{
	pixel_x = 2;
	pixel_y = 3
	},
/obj/item/device/scanner/mining{
	pixel_x = -6;
	pixel_y = -1
	},
/obj/random/trash,
/turf/simulated/floor/tiled/dark,
/area/map_template/abandoned_church)
"Gi" = (
/obj/machinery/light{
	dir = 8
	},
/turf/simulated/floor/carpet/blue,
/area/map_template/abandoned_church)
"Jg" = (
/obj/effect/floor_decal/corner/brown/diagonal,
/obj/structure/cable/yellow{
	d2 = 8;
	icon_state = "0-8"
	},
/obj/machinery/power/port_gen/pacman,
/turf/simulated/floor/tiled/dark,
/area/map_template/abandoned_church)
"JJ" = (
/obj/structure/table/woodentable/maple,
/obj/item/device/flashlight/lantern,
/turf/simulated/floor/carpet/blue,
/area/map_template/abandoned_church)
"Ku" = (
/obj/structure/bed/chair/wood{
	dir = 1
	},
/turf/simulated/floor/wood/maple,
/area/map_template/abandoned_church)
"Ls" = (
/obj/effect/floor_decal/corner/blue/diagonal,
/obj/structure/closet/secure_closet/medical2,
/obj/random/medical,
/turf/simulated/floor/tiled/freezer,
/area/map_template/abandoned_church)
"LC" = (
/obj/effect/floor_decal/corner/purple/diagonal,
/obj/random/trash,
/obj/machinery/power/apc{
	dir = 4;
	icon_state = "apc0";
	pixel_x = 25
	},
/obj/structure/cable/yellow{
	d2 = 8;
	icon_state = "0-8"
	},
/turf/simulated/floor/tiled/steel_grid,
/area/map_template/abandoned_church)
"Nn" = (
/obj/structure/cable/yellow{
	d1 = 2;
	d2 = 8;
	icon_state = "2-8"
	},
/turf/simulated/floor/carpet/blue,
/area/map_template/abandoned_church)
"NL" = (
/obj/random/trash,
/turf/simulated/floor/carpet/blue,
/area/map_template/abandoned_church)
"OM" = (
/obj/effect/floor_decal/corner/grey/border,
/obj/structure/cable/yellow{
	d1 = 4;
	d2 = 8;
	icon_state = "4-8"
	},
/turf/simulated/floor/tiled/dark,
/area/map_template/abandoned_church)
"Pd" = (
/obj/effect/floor_decal/corner/blue/diagonal,
/obj/structure/cable/yellow{
	d1 = 4;
	d2 = 8;
	icon_state = "4-8"
	},
/turf/simulated/floor/tiled/freezer,
/area/map_template/abandoned_church)
"Pu" = (
/obj/effect/floor_decal/corner/blue/diagonal,
/mob/living/bot/medbot,
/turf/simulated/floor/tiled/freezer,
/area/map_template/abandoned_church)
"Qa" = (
/obj/machinery/door/airlock/science,
/obj/effect/floor_decal/corner/blue/diagonal,
/obj/structure/cable/yellow{
	d1 = 1;
	d2 = 2;
	icon_state = "1-2"
	},
/turf/simulated/floor/tiled/freezer,
/area/map_template/abandoned_church)
"Qk" = (
/obj/structure/table/woodentable,
/obj/item/storage/backpack/satchel,
/obj/machinery/light/small{
	dir = 1
	},
/turf/simulated/floor/tiled/dark,
/area/map_template/abandoned_church)
"Qs" = (
/obj/machinery/door/airlock/external/glass/bolted,
/obj/effect/floor_decal/corner/green/diagonal,
/obj/structure/barricade,
/turf/simulated/floor/tiled,
/area/map_template/abandoned_church)
"QN" = (
/obj/random/trash,
/obj/structure/cable/yellow{
	d1 = 4;
	d2 = 8;
	icon_state = "4-8"
	},
/turf/simulated/floor/carpet/blue,
/area/map_template/abandoned_church)
"RR" = (
/obj/machinery/door/airlock/science,
/obj/effect/floor_decal/corner/purple/diagonal,
/turf/simulated/floor/tiled/steel_grid,
/area/map_template/abandoned_church)
"RU" = (
/obj/structure/bed/chair/wood{
	dir = 1
	},
/obj/effect/floor_decal/carpet/blue{
	dir = 4
	},
/obj/effect/floor_decal/carpet/blue{
	dir = 1
	},
/obj/effect/floor_decal/carpet/blue{
	dir = 5
	},
/turf/simulated/floor/wood/maple,
/area/map_template/abandoned_church)
"Sf" = (
/obj/structure/table/woodentable,
/obj/item/device/flashlight/lantern{
	pixel_x = 2;
	pixel_y = 3
	},
/obj/item/device/flashlight/lantern{
	pixel_x = -4;
	pixel_y = -2
	},
/turf/simulated/floor/tiled/dark,
/area/map_template/abandoned_church)
"Sh" = (
/obj/structure/table/steel,
/obj/item/storage/toolbox/mechanical,
/obj/effect/floor_decal/corner/brown/diagonal,
/turf/simulated/floor/tiled/dark,
/area/map_template/abandoned_church)
"Sm" = (
/obj/structure/table/steel,
/obj/effect/floor_decal/corner/brown/diagonal,
/obj/item/stack/material/phoron/ten{
	pixel_x = 2
	},
/obj/item/wrench{
	pixel_y = 5
	},
/obj/random/material,
/turf/simulated/floor/tiled/dark,
/area/map_template/abandoned_church)
"SG" = (
/obj/effect/floor_decal/corner/brown/diagonal,
/obj/random/trash,
/turf/simulated/floor/tiled/dark,
/area/map_template/abandoned_church)
"TH" = (
/obj/effect/floor_decal/corner/green/diagonal,
/obj/random/mre,
/obj/structure/table/woodentable/maple,
/obj/machinery/light/small,
/turf/simulated/floor/tiled,
/area/map_template/abandoned_church)
"Uh" = (
/obj/structure/table/woodentable/maple,
/turf/simulated/floor/carpet/blue,
/area/map_template/abandoned_church)
"Up" = (
/obj/machinery/mining/brace{
	dir = 4
	},
/obj/effect/floor_decal/corner/brown/diagonal,
/turf/simulated/floor/tiled/dark,
/area/map_template/abandoned_church)
"VN" = (
/obj/effect/floor_decal/corner/green/diagonal,
/turf/simulated/floor/tiled,
/area/map_template/abandoned_church)
"Wl" = (
/obj/machinery/mining/drill,
/obj/effect/floor_decal/corner/brown/diagonal,
/turf/simulated/floor/tiled/dark,
/area/map_template/abandoned_church)
"Xb" = (
/obj/structure/table/steel,
/obj/effect/floor_decal/corner/purple/diagonal,
/turf/simulated/floor/tiled/steel_grid,
/area/map_template/abandoned_church)
"XT" = (
/obj/effect/floor_decal/corner/green/diagonal,
/obj/random/snack,
/obj/structure/table/woodentable/maple,
/obj/machinery/light/small{
	dir = 1
	},
/turf/simulated/floor/tiled,
/area/map_template/abandoned_church)
"XY" = (
/obj/effect/floor_decal/corner/grey/border,
/obj/structure/cable/yellow{
	d1 = 1;
	d2 = 4;
	icon_state = "1-4"
	},
/turf/simulated/floor/tiled/dark,
/area/map_template/abandoned_church)
"Ye" = (
/obj/effect/floor_decal/corner/purple/diagonal,
/obj/structure/cable/yellow{
	d1 = 1;
	d2 = 2;
	icon_state = "1-2"
	},
/turf/simulated/floor/tiled/steel_grid,
/area/map_template/abandoned_church)
"YQ" = (
/obj/structure/bed/chair/wood{
	dir = 1
	},
/obj/effect/floor_decal/carpet/blue{
	dir = 1
	},
/obj/effect/floor_decal/carpet/blue{
	dir = 8
	},
/obj/effect/floor_decal/carpet/blue{
	dir = 9
	},
/turf/simulated/floor/wood/maple,
/area/map_template/abandoned_church)
"Zs" = (
/obj/effect/floor_decal/corner/grey/border,
/obj/random/trash,
/obj/structure/cable/yellow{
	d1 = 4;
	d2 = 8;
	icon_state = "4-8"
	},
/turf/simulated/floor/tiled/dark,
/area/map_template/abandoned_church)
"ZB" = (
/obj/structure/bed/chair/wood{
	dir = 1
	},
/obj/effect/floor_decal/carpet/blue{
	dir = 8
	},
/turf/simulated/floor/wood/maple,
/area/map_template/abandoned_church)
"ZM" = (
/obj/machinery/door/airlock/external/glass/bolted,
/obj/effect/floor_decal/corner/brown/diagonal,
/obj/structure/barricade,
/turf/simulated/floor/tiled/dark,
/area/map_template/abandoned_church)

(1,1,1) = {"
xT
xT
xT
DB
DB
DB
DB
DB
DB
DB
DB
DB
DB
DB
DB
DB
"}
(2,1,1) = {"
xT
xT
xT
DB
us
nd
ov
nd
od
ac
DB
Ls
zC
Pu
wa
DB
"}
(3,1,1) = {"
xT
xT
xT
DB
rS
nd
nd
nd
nd
ov
DB
Aq
zz
zC
iP
DB
"}
(4,1,1) = {"
xT
xT
xT
DB
FA
nd
nd
nd
nd
wv
DB
mY
zC
zC
wF
DB
"}
(5,1,1) = {"
xT
xT
xT
DB
AF
ov
nd
nd
Al
Ye
Qa
ak
zC
zC
wa
DB
"}
(6,1,1) = {"
xT
xT
xT
DB
Xb
nd
nd
nd
LC
nd
DB
Pd
zC
zz
iP
DB
"}
(7,1,1) = {"
xT
xT
vx
DB
DB
DB
RR
DB
DB
DB
DB
fZ
DB
DB
DB
DB
"}
(8,1,1) = {"
xT
vx
vx
dp
Gi
Fa
Fa
Fa
Fa
Gi
Fa
QN
DB
mj
oi
DI
"}
(9,1,1) = {"
vx
vx
Fa
Fa
Fa
Fa
lw
ZB
ZB
zP
Fa
pX
DB
FO
oi
DI
"}
(10,1,1) = {"
vx
Fa
Fa
Ex
JJ
Fa
jR
tM
Ku
uD
Fa
pX
DB
Qk
oi
DI
"}
(11,1,1) = {"
vx
Fa
Fa
Fa
Uh
Fa
Fa
RU
xC
nA
Fa
pX
DB
wr
oi
DB
"}
(12,1,1) = {"
vx
Fa
Fa
Fa
uJ
Fa
Fa
Fa
NL
Fa
Fa
Nn
es
cc
XY
yT
"}
(13,1,1) = {"
vx
NL
Fa
Fa
Uh
Fa
Fa
lw
ZB
Dz
Fa
Fa
DB
wr
OM
DB
"}
(14,1,1) = {"
vx
Fa
Fa
Uh
JJ
Fa
YQ
sp
Ku
uD
Fa
Fa
DB
gE
Zs
DI
"}
(15,1,1) = {"
vx
vx
Fa
Fa
Fa
Fa
RU
xC
xC
nA
Fa
Fa
DB
Sf
OM
DI
"}
(16,1,1) = {"
xT
vx
vx
Fa
fe
Fa
Fa
Fa
NL
fe
Fa
Fa
DB
aj
OM
DI
"}
(17,1,1) = {"
xT
xT
vx
DB
DB
DB
DB
vm
DB
DB
DB
DB
DB
DB
wc
DB
"}
(18,1,1) = {"
xT
xT
xT
DB
VN
VN
pK
VN
pK
VN
VN
DB
Wl
Dc
jy
DB
"}
(19,1,1) = {"
xT
xT
xT
DB
rg
TH
DB
VN
DB
AE
rg
DB
Up
SG
jy
DB
"}
(20,1,1) = {"
xT
xT
xT
DB
DB
DB
DB
bZ
DB
DB
DB
DB
eW
Dc
Jg
DB
"}
(21,1,1) = {"
xT
xT
xT
DB
VN
VN
pK
VN
pK
VN
VN
DB
Sm
Dc
Dc
DB
"}
(22,1,1) = {"
xT
xT
xT
DB
rg
ih
DB
VN
DB
XT
rg
DB
Sh
Dc
SG
DB
"}
(23,1,1) = {"
xT
xT
xT
DB
DB
DB
DB
Qs
DB
DB
DB
DB
DB
DB
ZM
DB
"}
